************************************************
*                                              *
* * *** ************ *** ** ************ *** * *
* * *** *    ******* **  ** *******    * *** * *
* * *** * **     *** **  ** ***     ** * *** * *
* *       ****** *** **  ** *** ******       * *
* ******* ****** *** ** *** *** ****** ******* *
*       *                              *       *
***** * * ************** ************* * * *****
*   * * * ************** ************* * * *   *
*     *                                  *     *
*   * * * ************* ************** * * *   *
***** * * ************* ************** * * *****
*       *                              *       *
* ******* ****** *** *** ** *** ****** ******* *
* *       ****** *** **  ** *** ******       * *
* * *** * **     *** **  ** ***     ** * *** * *
* * *** *    ******* **  ** *******    * *** * *
* * *** ************ ** *** ************ *** * *
*                                              *
************************************************
