*************************************************************************
**                                  *                                  **
** ** ********** *** **************   ************** *** ********* * * **
** ** ********** ***         **           **         *** ********* * * **
** **            *********** ** ********* ** ***********           * * **
** ** ********** *********** ** ********* ** *********** *********** * **
** **                                                                * **
** ******* *********** ************* ************* *********** ******* **
**       *                                                     *       **
****** * * **************** ******** ******** **************** * * ******
**   * * * **************** *               * **************** * * *   **
**     *                    * ************* *                    *     **
**   * * * **************** *               * **************** * * *   **
****** * * **************** ******** ******** **************** * * ******
**       *                                                     *       **
** ******* *********** ************* ************* *********** ******* **
** *                                                                ** **
** * *********** *********** ** ********* ** *********** ********** ** **
** * *           *********** ** ********* ** ***********            ** **
** * * ********* ***         **           **         *** ********** ** **  
** * * ********* *** **************   ************** *** ********** ** **
**                                  *                                  **
*************************************************************************